XXXXX
X H X
XXXXX
XXXXX
X   X
  X  
 XXX 
X F X
XXXXX
